@nastya_docs_support	-	-
@paul_molyanov	Павел	бизнесом
@uma_admins	София	-
@kkkvlm	Егор	нетворкингом
@SatoshlAds	-	-
@KumiKingKong	-	бизнесом
@SvetlanaShi	Светлана	экономикой
@traf_media	-	инвестициями
@alenamins	Алена	бизнесом
@patsak9876	Дмитрий	-
@maximkulgin	Максим	-
@konverti	Борис	-
@crptanec	-	трейдингом
@mister4e	Алексей	инвестициями
@EdyaManager	Олег	-
@andevoo	Андрей	бизнесом
@irademidovna	Ирина	-
@vipmon777	-	инвестициями
@cocuc	-	нейросетями
@nika_kravtc	Вероника	-
@Spiral_Yuri	Юрий	-
@moonytver	Александр	маркетингом
@smmakk	Андрей	-
@fearap	-	-
@mknewsads	-	-
@teftelkaaa	Андрей	-
@gaik1	-	ITтехнологиями
@polinarul	Полина	маркетингом
@OLEGGUT	София	маркетингом
@alfapolo	Олег	-
@Oce_q		-
justcage		-
@zhenya_magic		-
@lazysmm	женя	бизнесом
@jaMasha	Александр	рекламой
@zubar89	Мария	-
@agent_gr	Сергей	-
@HR_4_PR	Андрей	-
@borisova_anya	Ольга	PR-ом
@tochkaBzAdm	Анна	-
@Vladimir_motin		маркетингом
@wizavi	Владимир	маркетингом
@pervikirill	Константин	-
@Alivian	Кирилл	-
@travisfrosty	Игорь	-
@peachforme	Марат	маркетингом
@writemesm	Юлия	-
@LehaMSK	-	-
@odigitalad		-
@ale_reklam	Александр	-
@ashirokikh	Александр	-
@maxnatty	Максим	Рекламой
@A_nastasiaSemenova	Анастасия	PR-ом
@buss_ads	Максим	-
@Yulya_adm	Юлия	-
@ConsultPlanB	-	-
@Zvinogradova	Алена	-
@Lexrus_1	Руслан	-
@tribogatirya33	-	-
@digitalmarketingmoney	-	-
@tochkabis_adm	Виктор	-
@justcage	-	-
@maon_man	Константин	-
@asvorobey	Алексей	-
@bigpeter2	Пётр	-
@DigitalBublik_adm	-	-
@TheEdinorog	Дмитрий	-
@devmangx	-	-
@godinmedia	-	-
@srtest	-	-
@dimaa_dimaa	Дмитрий	-
@h7cker	-	-
@pech1nka	Анастасия	-
@g_abashkin	Генадий	-
@CodingLead	-	-
@adv_and_pr	Владислав	-
@maria_seniorfront	Мария	-
@ant_quit	-	-
@Loaderka	Никита	-
@web_runner	-	-
workakkk	-	-
@max_excel	Максим	-